########
#..#O..#
#.*#...#
#..#.P##
#..#.*##
#....O##
########
